4 4 4 4 4 4 4 4 4 4 4 4 4 4 4 4 4 4 4 4 4 4 4 4 4 4 4 4 4 4 4 4 4 4 4 4 4 4 4 4 4 4 4 4 4 4 4 4 4 4
4 4 4 4 4 4 4 4 4 4 4 4 4 4 3 3 3 3 3 3 3 3 3 3 3 3 3 3 3 3 3 3 3 3 3 3 3 3 3 3 3 3 3 3 3 3 3 3 3 4
4 4 4 4 4 4 4 4 4 4 4 4 4 4 2 2 2 2 2 2 2 2 2 2 2 2 2 2 2 2 2 2 2 2 2 2 2 2 2 2 2 2 2 2 2 2 2 2 2 4
4 4 4 4 4 4 4 4 4 4 4 4 4 4 1 0 1 0 1 0 1 0 1 0 1 0 1 0 1 0 1 0 1 0 1 0 1 0 1 0 1 0 1 0 1 0 1 0 1 4
4 4 4 4 4 4 4 4 4 4 4 4 4 4 0 1 0 1 0 1 0 1 0 1 0 1 0 1 0 1 0 1 0 1 0 1 0 1 0 1 0 1 0 1 0 1 0 1 0 4
4 4 4 4 4 4 4 4 4 4 4 4 4 4 1 0 1 0 1 0 1 0 1 0 1 0 1 0 1 0 1 0 1 0 1 0 1 0 1 0 1 0 1 0 1 0 1 0 1 4
4 4 4 4 4 4 4 4 4 4 4 4 4 4 0 1 0 1 0 1 0 1 0 1 0 1 0 1 0 1 0 1 0 1 0 1 0 1 0 1 0 1 0 1 0 1 0 1 0 4
4 4 4 4 4 4 4 4 4 4 4 4 4 4 1 0 1 0 1 0 1 0 1 0 1 0 1 0 1 0 1 0 1 0 1 0 1 0 1 0 1 0 1 0 1 0 1 0 1 4
4 4 4 4 4 4 4 4 4 4 4 4 4 4 0 1 0 1 0 4 4 4 4 4 4 4 4 4 4 4 4 4 0 1 0 1 0 1 0 1 0 1 0 1 0 1 0 1 0 4
4 4 4 4 4 4 4 4 4 4 4 4 4 4 1 0 1 0 1 4 4 4 4 4 4 4 4 4 4 4 4 4 1 0 1 0 1 0 1 0 1 0 1 0 1 0 1 0 1 4
4 4 4 4 4 4 4 4 4 4 4 4 4 4 0 1 0 1 0 4 4 4 4 4 4 4 4 4 4 4 4 4 0 1 0 1 0 1 0 1 0 1 0 1 0 1 0 1 0 4
4 4 4 4 4 4 4 4 4 4 4 4 4 4 1 0 1 0 1 4 4 4 4 4 4 4 4 4 4 4 4 4 1 0 1 0 1 0 1 0 1 0 1 0 1 0 1 0 1 4
4 4 4 4 4 4 4 4 4 4 4 4 4 4 0 1 0 1 0 4 4 4 4 4 4 4 4 4 4 4 4 4 0 1 0 1 0 1 0 1 0 1 0 1 0 1 0 1 0 4
4 4 4 4 4 4 4 4 4 4 4 4 4 4 1 0 1 0 1 4 4 4 4 4 4 4 4 4 4 4 4 4 1 0 1 0 1 0 1 0 1 0 1 0 1 0 1 0 1 4
4 4 4 4 4 4 4 4 4 4 4 4 4 4 0 1 0 1 0 4 4 4 4 4 4 4 4 4 4 4 4 4 0 1 0 1 0 1 0 1 0 1 0 1 0 1 0 1 0 4
4 4 4 4 4 4 4 4 4 4 4 4 4 4 1 0 1 0 1 4 4 4 4 4 4 4 4 4 4 4 4 4 1 0 1 0 1 0 1 0 1 0 1 0 1 0 1 0 1 4
4 4 4 4 4 4 4 4 4 4 4 4 4 4 0 1 0 1 0 4 4 4 4 4 4 4 4 4 4 4 4 4 0 1 0 1 0 1 0 1 0 1 0 1 0 1 0 1 0 4
4 4 4 4 4 4 4 4 4 4 4 4 4 4 1 0 1 0 1 4 4 4 4 4 4 4 4 4 4 4 4 4 1 0 1 0 1 0 1 0 1 0 1 0 1 0 1 0 1 4
4 4 4 4 4 4 4 4 4 4 4 4 4 4 0 1 0 1 0 4 4 4 4 4 4 4 4 4 4 4 4 4 0 1 0 1 0 1 0 1 0 1 0 1 0 1 0 1 0 4
4 4 4 4 4 4 4 4 4 4 4 4 4 4 1 0 1 0 1 4 4 4 4 4 4 4 4 4 4 4 4 4 1 0 1 0 1 0 1 0 1 0 1 0 1 0 1 0 1 4
4 4 4 4 4 4 4 4 4 4 4 4 4 4 0 1 0 1 0 4 4 4 4 4 4 4 4 4 4 4 4 4 0 1 0 1 0 1 0 1 0 1 0 1 0 1 0 1 0 4
4 4 4 4 4 4 4 4 4 4 4 4 4 4 1 0 1 0 1 4 4 4 4 4 4 4 4 4 4 4 4 4 4 4 4 4 4 4 4 4 4 4 4 4 4 4 4 4 4 4
4 4 4 4 4 4 4 4 4 4 4 4 4 4 0 1 0 1 0 4 3 3 3 3 3 3 3 3 3 3 3 4 4 4 4 4 4 4 4 4 4 4 4 4 4 4 4 4 4 4
4 4 4 4 4 4 4 4 4 4 4 4 4 4 1 0 1 0 1 4 2 2 2 2 2 2 2 2 2 2 2 4 4 4 4 4 4 4 4 4 4 4 4 4 4 4 4 4 4 4
4 4 4 4 4 4 4 4 4 4 4 4 4 4 0 1 0 1 0 4 0 1 0 1 0 1 0 1 0 1 0 4 4 4 4 4 4 4 4 4 4 4 4 4 4 4 4 4 4 4
4 4 4 4 4 4 4 4 4 4 4 4 4 4 1 0 1 0 1 4 1 0 1 0 1 0 1 0 1 0 1 4 4 4 4 4 4 4 4 4 4 4 4 4 4 4 4 4 4 4
4 4 4 4 4 4 4 4 4 4 4 4 4 4 0 1 0 1 0 4 0 1 0 1 0 1 0 1 0 1 0 4 4 4 4 4 4 4 4 4 4 4 4 4 4 4 4 4 4 4
4 4 4 4 4 4 4 4 4 4 4 4 4 4 1 0 1 0 1 4 1 0 1 0 1 0 1 0 1 0 1 4 4 4 4 4 4 4 4 4 4 4 4 4 4 4 4 4 4 4
4 4 4 4 4 4 4 4 4 4 4 4 4 4 0 1 0 1 0 1 0 1 0 1 0 1 0 1 0 1 0 4 4 4 4 4 4 4 4 4 4 4 4 4 4 4 4 4 4 4
4 4 4 4 4 4 4 4 4 4 4 4 4 4 1 0 1 0 1 0 1 0 1 0 1 0 1 0 1 0 1 4 4 4 4 4 4 4 4 4 4 4 4 4 4 4 4 4 4 4
4 4 4 4 4 4 4 4 4 4 4 4 4 4 0 1 0 1 0 1 0 1 0 1 0 1 0 1 0 1 0 4 4 4 4 4 4 4 4 4 4 4 4 4 4 4 4 4 4 4
4 4 4 4 4 4 4 4 4 4 4 4 4 4 1 0 1 0 1 4 4 4 4 4 4 4 4 4 4 4 4 4 4 4 4 4 4 4 4 4 4 4 4 4 4 4 4 4 4 4
4 4 4 4 4 4 4 4 4 4 4 4 4 4 0 1 0 1 0 4 3 3 3 3 3 3 3 3 3 3 3 3 3 3 3 3 3 3 3 4 4 4 4 4 4 4 4 4 4 4
4 4 4 4 4 4 4 4 4 4 4 4 4 4 1 0 1 0 1 4 2 2 2 2 2 2 2 2 2 2 2 2 2 2 2 2 2 2 2 4 4 4 4 4 4 4 4 4 4 4
4 4 4 4 4 4 4 4 4 4 4 4 4 4 0 1 0 1 0 4 0 1 0 1 0 1 0 1 0 1 0 1 0 1 0 1 0 1 0 4 4 4 4 4 4 4 4 4 4 4
4 4 4 4 4 4 4 4 4 4 4 4 4 4 1 0 1 0 1 4 1 0 1 0 1 0 1 0 1 0 1 0 1 0 1 0 1 0 1 4 4 4 4 4 4 4 4 4 4 4
4 4 4 4 4 4 4 4 4 4 4 4 4 4 0 1 0 1 0 4 0 1 0 1 0 1 0 1 0 1 0 1 0 1 0 1 0 1 0 4 4 4 4 4 4 4 4 4 4 4
4 4 4 4 4 4 4 4 4 4 4 4 4 4 1 0 1 0 1 4 1 0 1 0 1 0 1 0 1 0 1 0 1 4 1 0 1 0 1 4 4 4 4 4 4 4 4 4 4 4
4 4 4 4 4 4 4 4 4 4 4 4 4 4 0 1 0 1 0 4 0 1 0 1 0 1 0 1 0 1 0 1 0 4 0 1 0 1 0 4 3 3 3 3 3 3 3 3 3 4
4 4 4 4 4 4 4 4 4 4 4 4 4 4 1 0 1 0 1 4 1 0 1 0 1 0 1 0 1 0 1 0 1 4 1 0 1 0 1 4 2 2 2 2 2 2 2 2 2 4
4 4 4 4 4 4 4 4 4 4 4 4 4 4 0 1 0 1 0 4 0 1 0 1 0 1 0 1 0 1 0 1 0 4 0 1 0 1 0 4 0 1 0 1 0 1 0 1 0 4
4 4 4 4 4 4 4 4 4 4 4 4 4 4 1 0 1 0 1 4 1 0 1 0 1 0 1 0 1 0 1 0 1 4 1 0 1 0 1 3 1 0 1 0 1 0 1 0 1 4
4 4 4 4 4 4 4 4 4 4 4 4 4 4 0 1 0 1 0 1 0 1 0 1 0 1 0 1 0 1 0 1 0 4 0 1 0 1 0 2 0 1 0 1 0 1 0 1 0 4
4 4 4 4 4 4 4 4 4 4 4 4 4 4 1 0 1 0 1 0 1 0 1 0 1 0 1 0 1 0 1 0 1 4 1 0 1 0 1 0 1 0 1 0 1 0 1 0 1 4
4 4 4 4 4 4 4 4 4 4 4 4 4 4 0 1 0 1 0 1 0 1 0 1 0 1 0 1 0 1 0 1 0 4 0 1 0 1 0 1 0 1 0 1 0 1 0 1 0 4
4 4 4 4 4 4 4 4 4 4 4 4 4 4 1 0 1 0 1 4 1 0 1 0 1 0 1 0 1 0 1 0 1 4 1 0 1 0 1 0 1 0 1 0 1 0 1 0 1 4
4 4 4 4 4 4 4 4 4 4 4 4 4 4 0 1 0 1 0 4 0 1 0 1 0 1 0 1 0 1 0 1 0 4 0 1 0 1 0 4 0 1 0 1 0 1 0 1 0 4
4 4 4 4 4 4 4 4 4 4 4 4 4 4 4 4 4 4 4 4 4 4 4 4 4 4 4 4 4 4 4 4 4 4 4 4 4 4 4 4 4 4 4 4 1 0 1 4 4 4
5 5 5 5 5 5 5 5 5 5 5 5 5 5 5 5 5 5 5 5 5 5 5 5 5 5 5 5 5 5 5 5 5 5 5 5 5 5 5 5 5 5 5 4 0 1 0 4 5 5
5 5 5 5 5 5 5 5 5 5 5 5 5 5 5 5 5 5 5 5 5 5 5 5 5 5 5 5 5 5 5 5 5 5 5 5 5 5 5 5 5 5 5 5 5 5 5 5 5 5